2 2 2 2 2 2 2 2 2 2 2 2 2 2 2 2 2 2 2 2
0 0 2 0 0 0 0 0 0 0 0 0 0 0 0 6 2 2 2 2
0 2 0 0 0 0 0 0 0 0 0 2 2 2 0 0 2 0 0 2
0 2 0 0 0 0 2 0 2 0 0 2 2 2 0 0 2 0 2 2
0 2 0 0 0 0 2 0 2 0 0 2 2 2 0 0 2 0 2 0
0 0 0 0 0 0 2 4 2 0 0 0 0 0 0 0 0 0 2 0
1 0 0 0 0 0 0 2 0 0 0 0 0 0 0 0 0 0 0 3
0 2 0 0 0 0 0 0 0 0 0 2 0 0 0 0 0 0 2 0
0 2 2 0 0 2 0 0 2 0 2 0 0 0 2 0 0 2 0 0
0 0 2 0 2 2 0 0 2 2 0 0 0 0 2 2 2 2 0 0
0 0 2 2 2 0 0 0 0 2 5 0 0 0 0 0 0 0 2 0
